3 0 0 0 0 0 5 5 0 0 0 0 0 0 0 5 5 0 0 0 0 0 3 
3 3 0 0 0 0 0 0 5 0 0 0 0 0 5 0 0 0 0 0 0 3 3 
3 3 3 0 0 0 0 2 2 2 2 2 2 2 2 2 0 0 0 0 3 3 3 
3 1 3 3 0 0 0 2 4 4 2 2 2 4 4 2 0 0 0 3 3 1 3 
3 1 1 3 3 0 0 2 2 5 4 2 4 5 2 2 0 0 3 3 1 1 3 
3 3 3 3 3 3 0 2 2 2 2 2 2 2 2 2 0 3 3 3 3 3 3 
0 3 3 3 3 3 3 2 4 4 4 4 4 4 4 2 3 3 3 3 3 3 0 
0 0 3 3 3 3 0 2 2 4 5 5 5 4 2 2 0 3 3 3 3 0 0 
0 5 0 0 0 5 0 2 2 2 4 4 4 2 2 2 0 5 0 0 0 5 0 
5 0 0 0 0 5 0 0 0 2 2 2 2 2 0 0 0 5 0 0 0 0 5 